########5#3###G#
J>.......#.....#
2.###..#.#...#.6
#.#7..F#.A...###
#.#8.#.....#...E
#.4C...#.I.#####
B.#...D#.......9
#1#########H####