#########4####
#>.#A.B#...#C#
#..##..#...#.#
#...#........#
#..##.##.###.#
2.....#..3...#
#####1########