#####2####
3>.1A....5
4..###.#.#
B......###
#####6####