########5#3###G#
F>.......#.....#
2.###..#.#...#.6
#.#7...#.A...###
#.#8.#.....#...E
#.4C...#...#####
B.#...D#.......9
#1#########H####