##########
#>.1A..2.#
#..##....#
#........#
##########