##############
#>.1#.#2...###
#..##.##...#.#
#............#
######...#####
#............#
#####A########