##########3#####
#>.......#.....#
#.#4#..#.#...#.#
#.##..##.A...###
#.##.#.....*...#
#.##...#.C.#####
B.#...##.......#
#1#########2####