#########4####
#>.#A.1#...#C#
#..##..#...#.#
#............#
#..#########.#
2..5#####3...#
###########B##