##########3#####
#>.......#.....#
#.#4#..#.#...#.5
#.##..##.A...###
#.##.#.....#...#
#.##...#...#####
C.#...##.......B
#1#########2####