##############
#>.1#.#2...#C#
#..##.##...#.#
#............#
#####B##.###.#
3........#4..#
#####A########